111111111111111111111
100001000000001000001
101101011101101011101
101000000101000010001
101011110101011110101
100010000000000100001
111010111101110101101
100000100000010000101
101110101101010110101
100010001000100010001
110011100000001110111
100010001101100010001
101010100000001011101
101000111101111000101
101110100000010010101
100000101111010110001
101110001001000010101
101000101001111010101
101011100000000000101
100000001111110110001
111111111111111111111